0 0 0 0 0 0 0 0 0 1 19 5 4 4 4 4 4 8 0 0 0 0 0 5 4 9 4 4 7 0 0 32 34 43 46 56 16 13 0 0 0 0 0 0 0 0 0 0 13 0 0 0 0 0 14 14 14 14 14 0 0 29 37 40 49 52 13 19 1 0 0 0 0 0 0 0 0 0
0 0 0 0 0 0 0 0 0 1 15 14 14 14 14 14 14 13 0 0 0 0 0 0 0 13 19 0 0 0 0 31 35 42 47 54 16 13 0 0 0 0 0 0 0 0 0 0 13 22 23 24 0 0 0 0 13 0 0 0 0 28 38 39 50 51 13 19 1 0 0 0 0 0 0 0 0 0
0 0 0 0 0 0 0 0 0 1 0 0 0 0 0 0 0 13 0 2 0 2 2 0 0 13 19 0 22 23 24 30 36 41 48 53 16 13 0 0 0 0 0 0 0 0 0 2 13 25 26 27 0 0 0 0 13 0 0 0 0 1 1 13 1 1 13 19 1 0 0 0 0 0 0 0 0 0
0 0 0 0 0 0 0 0 0 1 0 0 0 0 0 0 0 11 4 4 4 4 4 4 4 7 19 0 25 26 27 29 37 40 49 52 16 13 87 86 0 0 0 17 21 21 21 21 13 21 21 21 21 21 20 0 5 4 4 4 8 0 0 13 0 2 13 19 1 0 0 0 0 0 0 0 0 0
0 0 0 0 0 0 0 0 0 1 6 4 8 0 0 6 4 7 17 21 21 21 21 21 21 21 18 0 0 0 0 28 38 39 50 51 16 13 0 0 0 0 0 16 6 4 4 4 12 4 4 4 4 8 19 0 0 0 0 2 13 0 0 13 0 0 13 0 1 0 0 0 0 0 0 0 0 0
0 0 0 0 0 0 0 0 0 1 13 0 13 0 0 13 17 21 18 0 0 0 0 0 0 0 6 4 4 4 4 8 0 0 1 1 16 13 0 0 0 0 0 16 13 0 0 0 0 0 0 0 0 13 19 0 0 0 0 0 13 0 0 13 0 0 13 0 1 0 0 0 0 0 0 0 0 0
0 0 0 0 0 0 0 0 0 1 1 1 1 1 1 1 1 62 73 74 1 1 21 21 21 21 21 21 21 20 1 1 1 1 1 1 1 1 1 1 1 1 1 1 1 1 1 1 1 1 1 1 1 21 21 21 21 21 21 21 21 21 21 1 1 1 1 19 1 0 0 0 0 0 0 0 0 0
0 0 0 0 0 0 0 0 0 1 4 9 4 4 8 0 61 63 72 75 85 0 4 4 4 4 4 4 8 19 0 0 0 0 2 0 0 0 0 0 0 0 0 19 0 0 0 0 0 0 0 0 0 0 0 0 6 4 4 4 4 4 4 4 4 4 8 19 1 0 0 0 0 0 0 0 0 0
0 0 0 0 0 0 0 0 0 21 20 13 0 0 13 0 60 64 71 76 83 0 0 0 0 0 0 0 13 19 0 0 0 0 0 0 0 0 0 0 0 0 0 19 0 0 0 0 0 0 2 2 0 0 0 0 13 89 0 0 0 0 0 0 0 0 13 19 1 0 0 0 0 0 0 0 0 0
0 0 0 0 0 0 0 0 0 1 19 13 0 0 13 0 59 65 70 77 82 2 0 0 0 0 0 0 13 19 0 0 2 0 0 0 0 0 0 0 0 0 0 19 6 4 4 4 9 4 4 4 4 4 4 4 10 88 0 0 0 0 33 44 45 0 13 19 1 0 0 0 0 0 0 0 0 0
0 0 0 0 0 0 0 0 0 1 19 13 0 0 13 2 58 66 69 78 81 2 0 6 4 4 0 0 11 4 4 4 4 4 4 4 4 8 0 0 0 0 0 19 13 0 0 0 13 0 0 0 0 0 0 0 13 0 0 0 0 32 34 43 46 55 13 19 1 0 0 0 0 0 0 0 0 0 
0 0 0 0 0 0 0 0 0 1 19 13 0 0 13 2 57 67 68 79 80 0 0 13 22 23 24 0 13 0 0 0 0 0 0 0 16 13 0 0 0 0 0 19 13 0 0 0 13 0 0 0 0 0 0 0 13 0 0 0 0 31 35 42 47 54 13 19 1 0 0 0 0 0 0 0 0 0 
0 0 0 0 0 0 0 0 0 1 19 13 0 0 0 0 0 0 0 0 0 0 0 13 25 26 27 0 13 0 0 0 33 44 45 0 16 11 4 4 4 4 4 4 7 0 0 0 13 0 0 0 0 0 0 0 13 2 0 0 0 30 36 41 48 53 13 19 1 0 0 0 0 0 0 0 0 0
0 0 0 0 0 0 0 0 0 1 19 5 4 4 4 4 4 8 0 0 0 0 0 5 4 9 4 4 7 0 0 32 34 43 46 56 16 13 0 0 0 0 0 0 0 0 0 0 13 0 0 0 0 0 14 14 14 14 14 0 0 29 37 40 49 52 13 19 1 0 0 0 0 0 0 0 0 0
0 0 0 0 0 0 0 0 0 1 15 14 14 14 14 14 14 13 0 0 0 0 0 0 0 13 19 0 0 0 0 31 35 42 47 54 16 13 0 0 0 0 0 0 0 0 0 0 13 22 23 24 0 0 0 0 13 0 0 0 0 28 38 39 50 51 13 19 1 0 0 0 0 0 0 0 0 0
0 0 0 0 0 0 0 0 0 1 0 0 0 0 0 0 0 13 0 2 0 2 2 0 0 13 19 0 22 23 24 30 36 41 48 53 16 13 0 0 0 0 0 0 0 0 0 2 13 25 26 27 0 0 0 0 13 0 0 0 0 1 1 13 1 1 13 19 1 0 0 0 0 0 0 0 0 0
0 0 0 0 0 0 0 0 0 1 0 0 0 0 0 0 0 11 4 4 4 4 4 4 4 7 19 0 25 26 27 29 37 40 49 52 16 13 87 86 0 0 0 17 21 21 21 21 13 21 21 21 21 21 20 0 5 4 4 4 8 0 0 13 0 2 13 19 1 0 0 0 0 0 0 0 0 0
0 0 0 0 0 0 0 0 0 1 6 4 8 0 0 6 4 7 17 21 21 21 21 21 21 21 18 0 0 0 0 28 38 39 50 51 16 13 0 0 0 0 0 16 6 4 4 4 12 4 4 4 4 8 19 0 0 0 0 2 13 0 0 13 0 0 13 0 1 0 0 0 0 0 0 0 0 0
0 0 0 0 0 0 0 0 0 1 13 0 13 0 0 13 17 21 18 0 0 0 0 0 0 0 6 4 4 4 4 8 0 0 1 1 16 13 0 0 0 0 0 16 13 0 0 0 0 0 0 0 0 13 19 0 0 0 0 0 13 0 0 13 0 0 13 0 1 0 0 0 0 0 0 0 0 0
0 0 0 0 0 0 0 0 0 1 13 0 13 2 0 13 19 0 0 0 0 0 0 0 0 0 13 17 21 21 20 13 0 0 0 0 16 13 0 0 0 0 0 16 13 0 0 0 0 0 0 0 0 13 19 0 0 0 0 0 13 0 0 13 0 0 0 0 1 0 0 0 0 0 0 0 0 0
0 0 0 0 0 0 0 0 0 1 13 0 5 4 4 7 19 0 0 0 0 0 0 0 0 6 7 16 0 0 19 13 0 0 0 2 16 13 0 0 0 0 0 16 13 0 0 62 73 74 0 2 0 13 19 0 0 0 0 0 13 0 19 13 0 0 0 0 1 0 0 0 0 0 0 0 0 0 
0 0 0 0 0 0 0 0 0 1 13 0 14 14 14 14 18 0 0 0 0 0 6 4 4 10 17 21 0 0 0 13 0 0 0 0 0 0 0 6 4 4 4 4 7 0 61 63 72 75 85 2 0 13 19 0 87 86 0 0 13 0 19 13 0 0 0 0 1 0 0 0 0 0 0 0 0 0
0 0 0 0 0 0 0 0 0 1 13 0 0 0 0 0 0 0 0 0 0 0 13 0 0 13 16 0 0 0 0 13 22 23 24 0 0 0 0 13 0 0 0 16 0 26 60 64 71 76 83 0 0 0 19 0 0 0 0 0 13 0 19 5 9 4 4 4 1 0 0 0 0 0 0 0 0 0
0 0 0 0 0 0 0 0 0 1 5 4 8 0 0 0 0 6 4 4 4 4 7 0 0 13 16 0 0 0 0 13 25 26 27 0 0 2 0 13 0 0 26 16 0 26 59 65 70 77 82 0 0 0 19 0 0 0 0 0 13 0 19 0 13 0 0 0 1 0 0 0 0 0 0 0 0 0
0 0 0 0 0 0 0 0 0 21 21 20 13 0 0 0 0 13 14 14 14 14 14 0 0 13 16 0 0 0 0 11 4 4 4 4 4 4 9 7 0 0 0 16 0 0 58 66 69 78 81 0 0 0 19 0 0 0 0 0 13 2 19 0 13 0 0 0 1 0 0 0 0 0 0 0 0 0
0 0 0 0 0 0 0 0 0 1 0 16 13 0 2 0 0 13 0 0 0 0 0 0 0 13 0 0 0 0 19 13 0 21 21 21 21 21 13 0 0 0 0 16 0 2 57 67 68 79 80 0 0 0 19 0 0 2 0 0 13 0 0 2 13 0 0 0 1 0 0 0 0 0 0 0 0 0
0 0 0 0 0 0 0 0 0 1 0 16 5 4 4 4 4 7 0 0 0 0 0 0 19 13 0 0 0 2 19 13 0 0 0 0 0 0 13 0 0 0 0 16 0 0 0 0 0 0 6 4 4 4 4 4 4 9 4 4 7 0 0 21 21 21 21 0 1 0 0 0 0 0 0 0 0 0 
0 0 0 0 0 0 0 0 0 1 0 15 21 21 21 21 21 21 0 2 0 0 14 14 18 13 0 89 0 0 19 13 0 0 0 0 0 0 13 2 2 0 0 15 14 14 14 14 14 0 13 22 23 24 0 0 0 13 0 0 0 0 0 0 13 0 0 0 1 0 0 0 0 0 0 0 0 0
0 0 0 0 0 0 0 0 0 1 0 0 0 0 0 0 0 0 0 0 6 4 9 4 4 10 0 88 0 0 19 13 0 2 0 0 19 0 13 0 0 0 0 0 6 4 4 4 4 4 10 25 26 27 0 0 0 11 4 4 4 4 4 4 7 0 0 0 1 0 0 0 0 0 0 0 0 0 
0 0 0 0 0 0 0 0 0 1 0 0 0 0 0 0 0 0 0 0 13 0 13 19 0 13 0 0 0 0 19 13 0 2 0 0 19 0 13 0 0 2 0 0 13 0 0 0 0 0 5 4 4 4 8 0 0 13 0 2 0 0 0 0 0 0 0 0 1 0 0 0 0 0 0 0 0 0
0 0 0 0 0 0 0 0 0 1 21 21 21 21 0 6 4 4 4 4 7 0 13 19 0 13 14 14 14 14 18 13 0 0 0 2 19 0 5 4 4 9 4 4 7 0 0 0 0 0 0 0 0 0 13 0 0 0 0 14 14 14 14 14 14 14 0 0 1 0 0 0 0 0 0 0 0 0
0 0 0 0 0 0 0 0 0 1 0 6 4 4 4 10 22 23 24 0 0 0 13 19 0 5 4 4 4 0 0 13 0 0 0 13 19 0 0 0 0 13 0 0 0 0 0 0 0 0 0 0 0 0 13 0 0 6 4 4 4 4 4 8 0 0 0 0 1 0 0 0 0 0 0 0 0 0
0 0 0 0 0 0 0 0 0 1 0 13 0 0 16 13 25 26 27 0 0 0 13 2 0 0 0 0 0 0 0 13 0 0 0 13 19 0 0 0 0 13 0 0 0 21 21 21 21 21 21 21 21 0 13 0 0 13 16 0 0 0 0 13 0 0 0 0 1 0 0 0 0 0 0 0 0 0
0 0 0 0 0 0 0 0 0 1 0 13 0 0 16 5 4 4 4 4 8 0 5 4 8 0 0 0 0 0 0 5 4 4 4 10 19 0 0 0 0 13 19 0 0 0 0 6 4 4 4 4 4 7 0 0 13 16 0 0 0 0 13 0 0 0 0 0 1 0 0 0 0 0 0 0 0 0
0 0 0 0 0 0 0 0 0 1 4 10 0 0 16 0 0 0 0 0 13 0 0 0 5 4 4 4 0 0 0 0 0 0 0 13 19 0 0 0 0 13 19 0 0 0 0 16 13 0 0 0 0 0 0 0 0 13 16 0 0 0 0 13 0 0 0 0 1 0 0 0 0 0 0 0 0 0
0 0 0 0 0 0 0 0 0 1 19 13 0 0 16 0 0 0 0 0 13 0 0 0 0 0 0 0 0 0 0 0 0 0 0 5 4 4 4 4 4 7 19 0 0 0 0 16 13 0 0 2 0 0 0 0 0 13 16 0 0 0 0 13 0 0 0 0 1 0 0 0 0 0 0 0 0 0
0 0 0 0 0 0 0 0 0 1 19 13 0 0 0 0 0 0 2 0 0 0 0 0 0 0 0 0 2 0 0 89 0 0 22 23 24 0 14 14 14 0 19 0 0 0 0 16 5 4 4 4 4 4 4 4 4 7 16 0 0 0 0 13 0 0 0 0 1 0 0 0 0 0 0 0 0 0
0 0 0 0 0 0 0 0 0 1 19 5 4 4 4 4 4 4 4 4 4 4 4 4 4 4 0 0 0 0 0 88 0 0 25 26 27 0 0 0 0 0 19 2 2 0 0 16 0 0 0 0 0 0 0 0 0 0 16 0 0 0 0 5 4 4 4 4 1 0 0 0 0 0 0 0 0 0
0 0 0 0 0 0 0 0 0 1 1 1 1 1 1 1 1 1 1 1 1 1 1 1 1 1 1 1 1 1 1 1 1 1 1 1 1 1 1 1 1 1 1 1 1 1 1 1 1 1 1 1 1 1 1 1 1 1 1 1 1 1 1 1 1 1 1 1 1 0 0 0 0 0 0 0 0 0
0 0 0 0 0 0 0 0 0 1 0 13 0 0 16 5 4 4 4 4 8 0 5 4 8 0 0 0 0 0 0 5 4 4 4 10 19 0 0 0 0 13 19 0 0 0 0 6 4 4 4 4 4 7 0 0 13 16 0 0 0 0 13 0 0 0 0 0 1 0 0 0 0 0 0 0 0 0
0 0 0 0 0 0 0 0 0 1 4 10 0 0 16 0 0 0 0 0 13 0 0 0 5 4 4 4 0 0 0 0 0 0 0 13 19 0 0 0 0 13 19 0 0 0 0 16 13 0 0 0 0 0 0 0 0 13 16 0 0 0 0 13 0 0 0 0 1 0 0 0 0 0 0 0 0 0
0 0 0 0 0 0 0 0 0 1 19 13 0 0 16 0 0 0 0 0 13 0 0 0 0 0 0 0 0 0 0 0 0 0 0 5 4 4 4 4 4 7 19 0 0 0 0 16 13 0 0 2 0 0 0 0 0 13 16 0 0 0 0 13 0 0 0 0 1 0 0 0 0 0 0 0 0 0
0 0 0 0 0 0 0 0 0 1 19 13 0 0 0 0 0 0 2 0 0 0 0 0 0 0 0 0 2 0 0 89 0 0 22 23 24 0 14 14 14 0 19 0 0 0 0 16 5 4 4 4 4 4 4 4 4 7 16 0 0 0 0 13 0 0 0 0 1 0 0 0 0 0 0 0 0 0
0 0 0 0 0 0 0 0 0 1 19 5 4 4 4 4 4 4 4 4 4 4 4 4 4 4 0 0 0 0 0 88 0 0 25 26 27 0 0 0 0 0 19 2 2 0 0 16 0 0 0 0 0 0 0 0 0 0 16 0 0 0 0 5 4 4 4 4 1 0 0 0 0 0 0 0 0 0
